0566mmbb80
0000m0010b
0bb101mm2m
0mmm0m002m
21m002m4m0
415mm1b30b
4b1m02000b
0b1b3bbm00
7m1m30m0m0
000000m009