0m10000222
0000570138
0b10000135
0m1000b133
0m110bm112
011000m12b
0b1mm1mm00
0m32120000
6m2100m041
0b1100mb49