0000007000
0084444005
mbmb11bmbm
7100000033
1100000036
bmbm33mbmb
8200220044
2200000047
mbmb44bmbm
6000330239